1111111111111111111111111
1000000000110000000000001
1011000001110000000000001
1001000000000000000000001
1111111110110000000000001
1000000000111111110111111
1111011000000000010010001
1100000011010101110W00001
1000000000000000110000001
1000000000000000110100001
1100000111010101111000111
1111011111101011011010001
1111111111111111111111111